░░░░░░░░░░░░░░░░░░░░░░░░░░░░░░░░░░░░▒▒░░░░░░░░░░░░░░░░░░░░░░░░░░░░░░░░░░░░░░░░░░░░░░░░░░
░░░░░░░░░░░░░░░░░░░░░░░░░░░░░░░░░░░░░░▒████▓▒▒░░░░░░░░░░░░░░░░░░░░░░░░░░░░░░░░░░░░░░░░░░░░
░░░░░░░░░░░░░░░░░░░░░░░░░░░░░░░░░░░░░░░▓█████▓▓▓▒░░░░░░░░░░░░░░░░░░░░░░░░░░░░░░░░░░░░░░░░░
░░░░░░░░░░░░░░░░░░░░░░░░░░░░░░░░░░░░░░░░██████▓▓▓▒░░░░░░░░░░░░░░░░░░░░░░░░░░░░░░░░░░░░░░░░
░░░░░░░░░░░░░░░░░░░░░░░░▓▓▓████▓▓▓▓▒▒░░░▓██████▓▓▓▒░░░░░░░░░░░░░░░░░░░░░░░░░░░░░░░░░░░░░░░
░░░░░░░░░░░░░░░░░░░░░░░░░▒█████████▓▓▓▓▒▒███████▓▓▓░░░░░░░░░░░░░░░░░░░░░░░░░░░░░░░░░░░░░░░
░░░░░░░░░░░░░░░░░░░░░░░░░░░▒██████████▓▓████████▓▓▓▓░░░░░░░░░░░░░░░░░░░░░░░░░░░░░░░░░░░░░░
░░░░░░░░░░░░░░░░░░░░░░░░░░░░░▒█████████▓▓███████████▓▓▒░░░░░░░░░░░░░░░░░░░░░░░░░░░░░░░░░░░
░░░░░░░░░░░░░░░░░░░░░░░░░░░░░░░██████████████████████████▒░░░░░░░░░░░░░░░░░░░░░░░░░░░░░░░░
░░░░░░░░░░░░░░░░░░░░░░░░░░░░▒▒▒▒███████████████████████████░░░░░░░░░░░░░░░░░░░░░░░░░░░░░░░
░░░░░░░░░░░░░░░░░░░░░░▒▒▓████▓▓▓████████████████████████████░░░░░░░░░░░░░░░░░░░░░░░░░░░░░░
░░░░░░░░░░░░░░░░░░░▒▓███████████████████████████████████████▓░░░░░░░░░░░░░░░░░░░░░░░░░░░░░
░░░░░░░░░░░░░░░░░░░▒▓████████████████████████████████████████▒▒▒▒▒▒▒▒▒▒░░░░░░░░░░░░░░░░░░░
░░░░░░░░░░░░░░░░░░░░░░░░▒▓█████████████████████▓█████████████████████████▓░░░░░░░░░░░░░░░░
░░░░░░░░░░░░░░░░░░░░░░░░░░░▒▓████████████████▓▓▓▓████▓▓███████████████▓▒░░░░░░░░░░░░░░░░░░
░░░░░░░░░░░░░░░░░░░░░░░░░░░░░░▒█████████████▓▒▒▒███▓▓▓▒▓█▓████████▓▒░░░░░░░░░░░░░░░░░░░░░░
░░░░░░░░░░░░░░░░░░░░░░░░░▒▓▓██████▒█████▓██▓▒░░███▓▒░░▒█▓███▓███████▓▓▓▒▒░░░░░░░░░░░░░░░░░
░░░░░░░░░░░░░░░░░░░░░░░░░▒▓▓█████▓▒▓█▓▓████▒░░░█▓▒░░▒▓█▓▒▓▒▒▓███████▓▒░░░░░░░░░░░░░░░░░░░░
░░░░░░░░░░░░░░░░░░░░░░░░░░░░░░▒▒▓█▒░▓▓▓▓░░▒██▒▒▓░▒▓█▒░░░░▓▒▒████▒░░░░░░░░░░░░░░░░░░░░░░░░░
░░░░░░░░░░░░░░░░░░░░░░░░░░░░░░░░░░█▓▒▒▓▓▒▒▒▒▒▒▒▒▒▒▒░░░░░▒▒▓███▓▒░░░░░░░░░░░░░░░░░░░░░░░░░░
░░░░░░░░░░░░░░░░░░░░░░░░░░░░░░░░▒██████▓▓▒▒░░▒▒░░░░░▒░░▒▓███▓▓▓▒▒▒░░░░░░░░░░░░░░░░░░░░░░░░
░░░░░░░░░░░░░░░░░░░░░░░░░░░░░░░░░░░░░░▒▓▓▒▒▒▒▒▓░░░░░░░░▒░░░░░░░░░░░░░░░░░░░░░░░░░░░░░░░░░░
░░░░░░░░░░░░░░░░░░░░░░░░░░░░░░░░░░░░░░▒▒▒▓▒▒▒▒▒▒▒░░░░▒░▒░░░░░░░░░░░░░░░░░░░░░░░░░░░░░░░░░░
░░░░░░░░░░░░░░░░░░░░░░░░░░░░░░░░░░░▒▒▒▒▒▒▒▓▓▒▒▒░░░▒▒▒░░▒░░░░░░░░░░░░░░░░░░░░░░░░░░░░░░░░░░
░░░░░░░░░░░░░░░░░░░░░░░░░░░░▒▓██▓▒▒▒▓▒▒▒▓▒▒▓▒▓▓▒▒▒▒▒▒░░░▒▒░░░▓█▒▒▒░░░░░░░░░░░░░░░░░░░░░░░░
░░░░░░░░░░░░░░░░░░░░░░░▒▒▓███▓██▓▓▓▓▒▒▒▒▓▓▒▒▒▒▒▒░▒▒▒▒░░░░▒▓▒▒▒█▓█▓▓▓▒▓▒░░░░░░░░░░░░░░░░░░░
░░░░░░░░░░░░░░░░░░░▒▓████▓██▓▓███▓▓▓▒▒▒▒▒▒░░▒▒▒▒▓▒░░░░░░▒▒▒▒▓▓▓█▓▓▓▓██▓▓▒░░░░░░░░░░░░░░░░░
░░░░░░░░░░░░░░░▒▓▓▓▓▓▓███▓██▓▓████▓▓▓▓▒▒▒▒▒▒░░░▒▒▒░░░░▒▒▒▓▓▓▓▓█▓▓▓▓▓██▓▓▓▓▓▓▒░░░░░░░░░░░░░
░░░░░░░░░░░░░░▒▓▓▓▓▓▓▓▓▓█▓██▓▓███████▓▓▓▒▒▒▒▒░░▓▒▒▒░░░▒▓▓▓▓▓███▓▓▓▓▓█▓▓▓▓▓▓▓▓▓▓▒▒░░░░░░░░░
░░░░░░░░░░░░░▓█▓▓▓▓▓▓▓▓▓▓▓▓█▓▓▓██████████▓▓▓▓▓▓▓▓▓▓▓▓▓▓▓██████▓▓▓▓▓▓▓▓▓▓▓▓▓▓▓▓▓▓▓░░░░░░░░░
░░░░░░░░░░░░▓██▓▓▓▓▓▓▓▓▓▓▓██▓▓▓▓███████████████▓▓▓▓▓█████████▓▓▓▓▓▓▓▓▓▓▓▓▓▓▓▓▓▓▓▓▒░░░░░░░░
░░░░░░░░░░░▓████▓▓▓▓▓▓▓▓▓▓▓█▓▓▓▓▓██████████████████████████▓▓▓▓▓▓▓▓▓▓▓▓▓▓▓▓▓▓▓▓▓▓▓▒░░░░░░░
░░░░░░░░░░▓█████▓▓▓█▓▓▓▓▓▓▓█▓▓▓▓▓▓▓█████████████████████▓▓▓▓▓▓▓▓▓▓▓▓▓▓▓▓▓▓▓▓▓▓▓█▓▓▓▒░░░